10 10
1 1 1 1 1 1 1 1 1 1
1 1 1 1 1 1 0 0 0 1
1 0 0 0 0 0 0 1 0 1
1 0 1 1 1 0 0 1 1 1
1 0 1 2 1 0 0 0 0 1
1 0 1 0 1 0 3 0 0 1
1 0 1 0 1 0 0 0 0 1
1 0 1 4 1 1 1 1 1 1
1 0 0 0 0 5 0 0 0 1
1 1 1 1 1 1 1 1 1 1
10
